######################
#.........##.........#
#.###.###.##.###.###.#
#o###.###.##.###.###o#
#....................#
#.###.##.####.##.###.#
#.....##...P...##....#
#####.####GG##########
    #.#...GG...#.#   
#####.#.######.#.#####
#.........##.........#
#.###.###.##.###.###.#
#o..#.............#o.#
###.#.##.####.########
#.....##...G...###...#
#.#######.##.#######.#
#....................#
######################
